11111111111111111111111111
1M001000000P00100000000001
1C0C0000000000100010010001
100000000C0000100010010001
1000C000000000010010010001
100000101000M00000010010E1
11111111111111111111111111
