111111111111111111111111111111
101C00000000000001111111111111
100000000000000000111111111111
100000000E00000001111111111111
100000000000000001111111111111
100000000000000001111111111111
10000000000000P001111111111111
111111111111111111111111111111
