1111111111111
1M0010000E001
1000000000001
1000000000001
10P0C00000001
1000001010001
1111111111111
