11111111111111
10000000E00011
10010000000001
10P100000C0001
11111111111111
