1111111111111
10001C000E001
1000000000001
1000000000001
10P00000C0001
1000001010001
1111111111111
