11111111111111
12222222222221
13333333333331
14444444444441
11111111111111
