11111111111111
100000000E0001
10000000000001
10P000000C0001
11111111111111
