11111111111111111111111111111111111111111111111111111111111
101C0000000000000000000000000000000000000000000000000000011
10000000000000000000000000000000000000000000000000000000011
100000000000000000000000000000E0000000000000000000000000011
10000000000000000000000000000000000000000000000000000000011
10000000000000000000000000000000000000000000000000000000011
10000000000000000000000000000000000000000000000000000001P11
11111111111111111111111111111111111111111111111111111111111
