1111111111111111111111111111
10P0000000000000000000000001
1000000C00000000000000000001
1000000000000000000000000001
10E0011000000000000000000001
1000000000000000000000000001
1000000000000000000000000001
1000000000000000000000000001
1000000000000000000000000001
1111111111111111111111111111
