1111111111111111111111111111
1000000000000000000000000001
1000000C0000000000C000000001
1000C0000000C000000000C00001
10E0011000000000000000000001
100000000000000C000000000001
1000000000000000000000000001
1000000C0000000C000000000001
1000000000000000000000C000P1
1111111111111111111111111111
