1111111111111111111111111111
1000010000000000000000000001
1000010C0000000000C000000001
1000C1000000C000000000C00001
10E1011011101111101111111111
100000000000000C010000000001
1000000000000000000001000001
1000000C0000000C010001000001
1000000000000000010001C000P1
1111111111111111111111111111
