11111111111111111111111111111
10010M0001P0010000000E0011111
1C0C0000001000100010010011111
100000000C0000100010010011111
1000C000000001010010010C01111
1000001010000C000000100101111
11111111111111111111111111111
11111111111111111111111111111
11111111111111111111111111111
11111111111111111111111111111
