11111111111111111111111111
10010M0001P001000000000011
1C0C0000001000100010010001
100000000C0000100010010001
1000C000000001010010010001
1000001010000C000000100101
11111111111111111111111111
11111111111111111111111111
111111111111111E1111111111
11111111111111111111111111
