11111111111111111111111111
10M1000000P001000000000011
1C0C0000000000100010010001
100000000C0000100010010001
1000C000000000010010010001
100000101000E0000000100101
11111111111111111111111111
