11111111111111111111111111111
10010M0001P001000000000011111
1C0C00000010001000100100E1111
100000000C0000100010010011111
1000C000000001010010010001111
1000001010000C000000100101111
11111111111111111111111111111
11111111111111111111111111111
11111111111111111111111111111
11111111111111111111111111111
